11111111111111111111
1P0000011C0C000CCC01
100001111000C00CC0C1
1C000110CC0C0C000001
1C0CC110CCC0C0000C01
10C000CC00CC0CC0C0C1
11111111000011000CC1
11111111111110001111
1E0000C0CC00C0C00001
11111111111111111111